x : 6 y : 3
x : 7 y : 3
x : 8 y : 3
x : 9 y : 3
x : 10 y : 3
x : 11 y : 3
x : 12 y : 3
x : 13 y : 3
x : 14 y : 3
x : 15 y : 3
x : 16 y : 3
x : 17 y : 3
x : 18 y : 3
x : 19 y : 3
x : 20 y : 3
x : 21 y : 3
x : 22 y : 3
x : 23 y : 3
x : 23 y : 4
x : 22 y : 4
x : 21 y : 4
x : 20 y : 4
x : 19 y : 4
x : 18 y : 4
x : 17 y : 4
x : 16 y : 4
x : 15 y : 4
x : 14 y : 4
x : 13 y : 4
x : 12 y : 4
x : 11 y : 4
x : 10 y : 4
x : 9 y : 4
x : 8 y : 4
x : 7 y : 4
x : 22 y : 4
x : 21 y : 4
x : 20 y : 4
x : 19 y : 4
x : 18 y : 4
x : 17 y : 4
x : 16 y : 4
x : 15 y : 4
x : 14 y : 4
x : 13 y : 4
x : 12 y : 4
x : 11 y : 4
x : 10 y : 4
x : 9 y : 4
x : 8 y : 4
x : 7 y : 4
x : 5 y : 3
x : 5 y : 4
x : 4 y : 4
x : 3 y : 4
------------------------------------
??????????????????????????????
????......................????
????#####################.????
????..T.................#.????
???X..#.................#.????
????#####################.????
??????????????????????????????
??????????????????????????????
??????????????????????????????
??????????????????????????????
??????????????????????????????
??????????????????????????????
??????????????????????????????
??????????????????????????????
??????????????????????????????
------------------------------------
??????????????????????????????
????......................????
????#####################.????
????..T.................#.????
????X.#.................#.????
????#####################.????
??????????????????????????????
??????????????????????????????
??????????????????????????????
??????????????????????????????
??????????????????????????????
??????????????????????????????
??????????????????????????????
??????????????????????????????
??????????????????????????????
------------------------------------
??????????????????????????????
????......................????
????#####################.????
????..T.................#.????
????.X#.................#.????
????#####################.????
??????????????????????????????
??????????????????????????????
??????????????????????????????
??????????????????????????????
??????????????????????????????
??????????????????????????????
??????????????????????????????
??????????????????????????????
??????????????????????????????
------------------------------------
??????????????????????????????
????......................????
????#####################.????
????.XT.................#.????
????..#.................#.????
????#####################.????
??????????????????????????????
??????????????????????????????
??????????????????????????????
??????????????????????????????
??????????????????????????????
??????????????????????????????
??????????????????????????????
??????????????????????????????
??????????????????????????????
------------------------------------
??????????????????????????????
????......................????
????#####################.????
????..X.................#.????
????..#.................#.????
????#####################.????
??????????????????????????????
??????????????????????????????
??????????????????????????????
??????????????????????????????
??????????????????????????????
??????????????????????????????
??????????????????????????????
??????????????????????????????
??????????????????????????????
